@0
  MOV UP, DOWN

@1
  MOV RIGHT, ACC
  SWP
  MOV 200 ACC
R:SUB 1
  JEZ E
  MOV NIL NIL
  MOV NIL NIL
  MOV NIL NIL
  MOV NIL NIL
  MOV NIL NIL
  MOV NIL NIL
  MOV NIL NIL
  JMP R
E:SWP
  MOV ACC DOWN

@2
  MOV UP, ACC
  SWP
  MOV 300 ACC
R:SUB 1
  JEZ E
  MOV NIL NIL
  MOV NIL NIL
  MOV NIL NIL
  MOV NIL NIL
  MOV NIL NIL
  MOV NIL NIL
  MOV NIL NIL
  JMP R
E:SWP
  MOV ACC LEFT

@3
  MOV UP, DOWN

@4
  MOV UP, ACC
  SWP
  MOV 300 ACC
R:SUB 1
  JEZ E
  MOV NIL NIL
  MOV NIL NIL
  MOV NIL NIL
  MOV NIL NIL
  MOV NIL NIL
  MOV NIL NIL
  MOV NIL NIL
  JMP R
E:SWP
  MOV ACC DOWN

@5
  MOV UP, DOWN

@6
  MOV UP, ACC
  SWP
  MOV 200 ACC
R:SUB 1
  JEZ E
  MOV NIL NIL
  MOV NIL NIL
  MOV NIL NIL
  MOV NIL NIL
  MOV NIL NIL
  MOV NIL NIL
  MOV NIL NIL
  JMP R
E:SWP
  MOV ACC RIGHT

@7
  MOV LEFT, ACC
  SWP
  MOV 250 ACC
R:SUB 1
  JEZ E
  MOV NIL NIL
  MOV NIL NIL
  MOV NIL NIL
  MOV NIL NIL
  MOV NIL NIL
  MOV NIL NIL
  MOV NIL NIL
  JMP R
E:SWP
  MOV ACC DOWN